╔═══════════╗  ╔══╦═════╦═════╗
║           ║  ║  ║     ║     ║
║  ╔═════╦══╝  ║  ║  ║  ╚══╗  ║
║  ║     ║     ║  ║  ║     ║  ║
║  ║  ║  ║  ╔══╝  ║  ║  ║  ║  ║
║  ║  ║  ║  ║        ║  ║     ║
║  ║  ║  ║  ║  ╔═════╣  ╚═════╣
║     ║     ║  ║     ║        ║
╠══   ╠═════╩══╝  ║  ╚══╗     ║
║     ║           ║     ║  ║  ║
║  ═══╝  ║  ║  ║  ╠══╗  ╠══╝  ║
║        ║  ║  ║  ║  ║  ║     ║
╠═════╦══╝  ║  ║  ║  ║  ║  ║  ║
║     ║     ║  ║     ║     ║  ║
║  ═══╣  ╔══╩══╬═════╝  ╔══╝  ║
║     ║  ║     ║        ║     ║
╠═══  ╚══╩══╗  ║  ║  ╔══╝  ╔══╣
║           ║     ║  ║     ║  ║
║  ═════════╩═════╝  ║  ═══╝  ║
║                    ║        ║
╚════════════════════╩════════╝